NO ./textures/north.xpm
SO ./textures/south.xpm
WE ./textures/west.xpm
EA ./textures/east.xpm
F 60,60,60
C 30,60,90

111111111111
100000000001
101111011101
1000N0010001
101011010101
100000000001
111111111111
