NO ./textures/north.xpm
SO ./textures/south.xpm
WE ./textures/west.xpm
EA ./textures/east.xpm
F 120,100,80
C 50,80,130

1111111111111111
1000000000100001
1011110110101101
1010000100000101
1010110101110101
1000100100010001
1110101111010111
1000100000010001
1011101011010101
1000001000000101
1011111011111101
1000000000N00001
1111111111111111
